{
  "world1":{
    "playerSpawn":[6,17],
    "items": [
      [0,0,0,0,0,0,0,0,0,0,0,0,0,0,0,0,0,0,0,0,0],
      [0,0,0,0,0,0,0,0,0,0,0,0,0,0,0,0,0,0,0,0,0],
      [0,0,0,0,0,0,0,0,0,0,0,0,0,0,0,0,0,0,0,0,0],
      [0,0,0,0,0,0,0,0,0,0,0,0,0,0,0,0,0,0,0,0,0],
      [0,0,0,0,0,0,0,0,0,0,0,0,0,0,0,0,0,0,0,0,0],
      [0,0,0,0,0,0,0,0,0,0,0,0,0,0,0,0,0,0,0,0,0],
      [0,0,0,0,0,0,0,0,0,0,0,0,0,0,0,0,0,0,0,0,0],
      [0,0,0,0,0,0,0,0,0,0,0,0,0,0,0,0,0,0,0,0,0],
      [0,0,0,0,0,0,0,0,0,0,0,0,0,0,0,0,0,0,0,0,0],
      [0,0,0,0,0,0,0,0,0,0,0,0,0,0,0,0,0,0,0,0,0],
      [0,0,0,0,0,0,0,0,0,0,0,0,0,0,0,0,0,0,0,0,0],
      [0,0,0,0,0,0,0,0,0,0,0,0,0,0,0,0,0,0,0,0,0],
      [0,0,0,0,0,0,0,0,0,0,0,0,0,0,0,0,0,0,0,0,0],
      [0,0,0,0,0,0,0,0,0,0,0,0,0,0,0,0,0,0,0,0,0],
      [0,0,0,0,0,0,0,0,0,0,0,0,0,0,0,0,0,0,0,0,0],
      [0,0,0,0,0,0,0,0,0,0,0,0,0,0,0,0,0,0,0,0,0],
      [0,0,0,0,0,0,0,0,0,0,0,0,0,0,0,0,0,0,0,0,0],
      [0,0,0,0,0,0,0,0,0,0,0,0,0,0,0,0,0,0,0,0,0],
      [0,0,0,0,0,0,0,0,0,0,0,0,0,0,0,0,0,0,0,0,0],
      [0,0,0,0,0,0,0,0,0,0,0,0,0,0,0,0,0,0,0,0,0],
      [0,0,0,0,0,0,0,0,0,0,0,0,0,0,0,0,0,0,0,0,0],
      [0,0,0,0,0,0,0,0,0,0,0,0,0,0,0,0,0,0,0,0,0],
      [0,0,0,0,0,0,0,0,0,0,0,0,0,0,0,0,0,0,0,0,0],
      [0,0,0,0,0,0,0,0,0,0,0,0,0,0,0,0,0,0,0,0,0],
      [0,0,0,0,0,0,0,0,0,0,0,0,0,0,0,0,0,0,0,0,0],
      [0,0,0,0,0,0,0,0,0,0,0,0,0,0,0,0,0,0,0,0,0],
      [0,0,0,0,0,0,0,0,0,0,0,0,0,0,0,0,0,0,0,0,0],
      [0,0,0,0,0,0,0,0,0,0,0,0,0,0,0,0,0,0,0,0,0],
      [0,0,0,0,0,0,0,0,0,0,0,0,0,0,0,0,0,0,0,0,0],
      [0,0,0,0,0,0,0,0,0,0,0,0,0,0,0,0,0,0,0,0,0],
      [0,0,0,0,0,0,0,0,0,0,0,0,0,0,0,0,0,0,0,0,0],
      [0,0,0,0,0,0,0,0,0,0,0,0,0,0,0,0,0,0,0,0,0]
    ],
    "objects": [
      [0,0,0,0,0,0,0,0,0,0,0,0,0,0,0,0,0,0,0,0,0],
      [0,0,0,0,0,0,0,0,0,0,0,0,0,0,0,0,0,0,0,0,0],
      [0,0,0,0,0,0,0,0,0,0,0,0,0,0,0,0,0,0,0,0,0],
      [0,0,0,0,0,0,0,0,0,0,0,0,0,0,0,0,0,0,0,0,0],
      [0,0,0,0,0,0,0,0,0,0,0,0,0,0,0,0,0,0,0,0,0],
      [0,0,0,0,0,0,0,0,0,0,0,0,0,0,0,0,0,0,0,0,0],
      [0,0,0,0,0,0,0,0,0,0,0,0,0,0,0,0,0,0,0,0,0],
      [0,0,0,0,0,0,0,0,0,0,0,0,0,0,0,0,0,0,0,0,0],
      [0,0,0,0,0,0,0,0,0,0,0,0,0,0,0,0,0,0,0,0,0],
      [0,0,0,0,0,0,0,0,0,0,0,0,0,0,0,0,0,0,0,0,0],
      [0,0,0,0,0,0,0,0,0,0,0,0,0,0,0,0,0,0,0,0,0],
      [0,0,0,0,0,0,0,0,0,0,0,0,0,0,0,0,0,0,0,0,0],
      [0,0,0,0,0,0,0,0,0,0,0,0,0,0,0,0,0,0,0,0,0],
      [0,0,0,0,0,0,0,0,0,0,0,0,0,0,0,0,0,0,0,0,0],
      [0,0,0,0,0,0,0,0,0,0,0,0,0,0,0,0,0,0,0,0,0],
      [0,0,0,0,0,0,0,0,0,0,0,0,0,0,0,0,0,0,0,0,0],
      [0,0,0,0,0,0,0,0,0,0,0,0,0,0,0,0,0,0,0,0,0],
      [0,0,0,0,0,0,0,0,0,0,0,0,0,0,0,0,0,0,0,0,0],
      [0,0,0,0,0,0,0,0,0,0,0,0,0,0,0,0,0,0,0,0,0],
      [0,0,0,0,0,0,0,0,0,0,0,0,0,0,0,0,0,0,0,0,0],
      [0,0,0,0,0,0,0,0,0,0,0,0,0,0,0,0,0,0,0,0,0],
      [0,0,0,0,0,0,0,0,0,0,0,0,0,0,0,0,0,0,0,0,0],
      [0,0,0,0,0,0,0,0,0,0,0,0,0,0,0,0,0,0,0,0,0],
      [0,0,0,0,0,0,0,0,0,0,0,0,0,0,0,0,0,0,0,0,0],
      [0,0,0,0,0,0,0,0,0,0,0,0,0,0,0,0,0,0,0,0,0],
      [0,0,0,0,0,0,0,0,0,0,0,0,0,0,0,0,0,0,0,0,0],
      [0,0,0,0,0,0,0,0,0,0,0,0,0,0,0,0,0,0,0,0,0],
      [0,0,0,0,0,0,0,0,0,0,0,0,0,0,0,0,0,0,0,0,0],
      [0,0,0,0,0,0,0,0,0,0,0,0,0,0,0,0,0,0,0,0,0],
      [0,0,0,0,0,0,0,0,0,0,0,0,0,0,0,0,0,0,0,0,0],
      [0,0,0,0,0,0,0,0,0,0,0,0,0,0,0,0,0,0,0,0,0],
      [0,0,0,0,0,0,0,0,0,0,0,0,0,0,0,0,0,0,0,0,0]
    ],
    "platform": [
      [9,9,9,9,9,9,9,9,9,9,9,9,9,9,9,9,9,9,9,9,9],
      [9,9,9,9,9,9,9,9,9,9,9,9,9,9,9,9,9,9,9,9,9],
      [9,9,9,9,9,9,9,9,9,9,9,9,9,9,9,9,9,9,9,9,9],
      [9,0,0,0,0,0,0,0,0,0,0,0,0,0,0,9,9,9,9,9,9],
      [9,0,0,0,0,0,0,0,0,0,0,0,0,0,0,0,9,9,9,9,9],
      [9,0,0,0,1,23,23,23,23,23,23,23,24,0,0,0,0,9,9,9,9],
      [9,0,0,0,0,0,0,0,0,0,0,0,0,0,0,2,0,0,9,9,9],
      [9,0,0,0,0,0,0,0,0,0,0,0,0,0,0,3,0,0,9,9,9],
      [9,0,0,0,0,1,23,23,23,23,23,24,0,0,0,3,0,0,9,9,9],
      [9,0,0,0,0,0,0,0,0,0,0,0,0,0,0,25,0,0,9,9,9],
      [9,0,0,0,0,0,0,0,0,0,0,0,0,0,0,26,0,0,9,9,9],
      [9,0,0,0,1,23,23,23,23,23,23,23,24,0,0,26,0,0,9,9,9],
      [9,0,0,0,0,0,0,0,0,0,0,0,0,0,0,26,0,0,9,9,9],
      [9,0,0,0,0,0,0,0,0,0,0,0,0,0,0,26,0,0,9,9,9],
      [9,0,0,0,0,1,23,23,23,23,23,24,0,0,0,27,0,0,0,9,9],
      [9,0,0,0,0,0,0,0,0,0,0,0,0,0,0,3,0,0,0,9,9],
      [9,0,0,0,0,0,0,0,0,0,0,0,0,0,0,3,0,0,0,9,9],
      [9,0,0,0,0,5,8,8,8,0,0,0,0,0,0,4,0,0,0,9,9],
      [9,0,0,0,0,6,9,9,9,0,0,0,0,0,0,0,0,0,0,9,9],
      [9,0,0,0,0,7,10,10,10,0,0,0,0,12,0,0,0,0,0,9,9],
      [9,0,0,0,0,0,0,0,0,0,0,0,0,13,0,0,0,0,9,9,9],
      [9,0,0,0,0,12,0,0,0,0,0,0,0,13,0,0,0,0,9,9,9],
      [9,0,0,0,0,13,0,0,0,0,0,0,0,14,0,0,0,0,9,9,9],
      [9,0,0,0,0,13,0,0,0,0,0,18,0,0,0,0,0,0,9,9,9],
      [9,0,0,0,0,14,0,0,18,0,0,0,0,0,0,0,0,0,9,9,9],
      [9,0,0,0,0,18,0,0,0,18,0,0,0,18,0,0,0,0,9,9,9],
      [9,0,0,0,0,0,18,0,0,0,0,0,0,0,0,0,0,0,9,9,9],
      [9,0,0,0,0,0,0,0,0,22,23,23,23,23,23,24,0,0,9,9,9],
      [9,0,0,0,0,0,0,0,0,0,0,0,0,0,0,0,0,0,9,9,9],
      [9,9,9,9,9,9,9,9,9,9,9,9,9,9,9,9,9,9,9,9,9],
      [9,9,9,9,9,9,9,9,9,9,9,9,9,9,9,9,9,9,9,9,9],
      [9,9,9,9,9,9,9,9,9,9,9,9,9,9,9,9,9,9,9,9,9]
    ]
  }
}
