{
	"world1":
		{
		  "playerSpawn":[3,6],
		  "items": [
			[0,0,0,0,0,0,0,0,0,0,0,0],
			[0,0,0,0,0,0,0,0,0,0,0,0],
			[0,0,0,0,0,0,0,0,0,0,0,0],
			[0,0,0,0,0,0,0,0,0,0,0,0],
			[0,0,0,0,0,0,0,0,0,0,0,0],
			[0,0,0,0,0,0,0,0,0,0,0,0],
			[0,0,0,0,0,0,0,0,0,0,0,0],
			[0,0,0,0,0,0,0,0,0,0,0,0],
			[0,0,0,0,0,0,0,0,0,0,0,0],
			[0,0,0,0,0,0,0,0,0,0,0,0],
			[0,0,0,0,0,0,0,0,0,0,0,0],
			[0,0,0,0,0,0,0,0,0,0,0,0],
			[0,0,0,0,0,0,0,0,0,0,0,0],
			[0,0,0,0,0,0,0,0,0,0,0,0],
			[0,0,0,0,0,0,0,0,0,0,0,0]
		  ],
		  "objects": [
			[0,0,0,0,0,0,0,0,0,0,0,0],
			[0,0,0,0,0,0,0,0,0,0,0,0],
			[0,0,0,0,0,0,0,0,0,0,0,0],
			[0,0,0,0,0,0,0,0,0,0,0,0],
			[0,0,0,0,1,0,0,0,0,0,0,0],
			[0,0,0,0,0,0,0,0,0,0,0,0],
			[0,0,0,0,0,0,0,0,0,0,0,0],
			[0,0,0,0,1,0,0,0,0,0,0,0],
			[0,0,0,0,0,0,0,0,0,0,0,0],
			[0,0,0,0,0,0,0,0,0,0,0,0],
			[0,0,0,0,1,0,0,0,0,0,0,0],
			[0,0,0,0,0,0,0,0,0,0,0,0],
			[0,0,0,0,0,0,0,0,0,0,0,0],
			[0,0,0,0,0,0,0,0,0,0,0,0],
			[0,0,0,0,0,0,0,0,0,0,0,0]
		  ],
		  "platform": [
			[9,9,9,9,9,9,9,9,9,9,9,0],
			[9,0,0,0,0,0,0,0,0,0,9,0],
			[9,0,0,0,0,0,0,2,0,0,9,0],
			[9,0,0,0,0,0,0,3,0,0,9,0],
			[9,0,0,0,0,0,0,3,0,0,9,0],
			[9,0,0,0,0,0,0,4,0,0,9,0],
			[9,0,0,0,0,0,0,0,0,0,9,0],
			[9,0,0,0,11,0,0,0,0,0,9,0],
			[9,0,0,0,0,0,0,0,0,0,9,0],
			[9,0,0,0,0,0,0,0,19,0,9,0],
			[9,0,0,0,0,0,0,0,21,0,9,0],
			[9,0,0,0,0,0,0,0,0,0,9,0],
			[9,23,23,23,23,23,23,24,0,0,9,0],
			[9,0,0,0,0,0,0,0,0,0,9,0],
			[9,9,9,9,9,9,9,9,9,9,9,0]
		  ]
		}
}
